000000000000000000000000000000000000000000000000000000000000000000000000000000000000000000000000000000000000000000000000000000000000000000000000000000000000000000000000000000000000000000000000
000000000000000000000000000000000000000000000000000000000000000000000000000000000000000000000000000000000000000000000000000000000000000000000000000000000000000000000000000000000000000000000000
000000000000000000000000000000000000000000000000000000000000000000000000000000000000000000000000000000000000000000000000000000000000000000000000000000000000000000000000000000000000000000000000
000000000000000000000000000000000000000000000000000000000000000000000000000000000000000000000000000000000000000000000000000000000000000000000000000000000000000000000000000000000000000000000000
000000000000000000000000000000000000000000000000000000000000000000000000000000000000000000000000000000000000000000000000000000000000000000000000000000000000000000000000000000000000000000000000
000000000000000000000000000000000000000000000000000000000000000000000000000000000000000000000000000000000000000000000000000000000000000000000000000000000000000000000000000000000000000000000000
000000000000000000000000000000000000000000000000000000000000000000000000000000000000000000000000000000000000000000000000000000000000000000000000000000000000000000000000000000000000000000000000
000000000000000000000000000000000000000000000000000000000000000000000000000000000000000000000000000000000000000000000000000000000000000000000000000000000000000000000000000000000000000000000000
000111111111111111111111111111111111111111111111111111111111111111111111111111111111111111111111111111111111111111111111111111111111111111111111111111111111111111111111111111111111111111111000
000111101101101101101101101101101101101101101101101101101101101101101101101101101101101101101101101101101101101101101101101101101101101101101101101101101101101101101101101101101101101101111000
000111101101101101101101101101101101101101101101101101101101101101101101101101101101101101101101101101101101101101101101101101101101101101101101101101101101101101101101101101101101101101111000
000111101101110110110110110110101101101110110101101101110110110110110110101101110110110110101101110110101101110110101101110110110110110101110110110110110110101110101101101110110101101101111000
000111101101110110110110110110000101110000000110101101110110110110110110000110110000000110110101110110000101110110000101110110110110000000110110110110110110000110110101101110110000101101111000
000111101101101000110110000000000110110000101110110101101000110110000000000110110000101101000000110110000101110110000101101000110110000101101101110110000000000110110000101110110000101101111000
000111101101101101110110000101101110110000101110110000101101110110000101101110110000101101101101110110000101110110000101101101110110000101101101110110000101101110110110101110110000101101111000
000111101101101101110110000101101110110000101110110000101101110110000101101101110110110110000101110110000101110110000101101101110110000101101101110110000101101110110110110110110000101101111000
000111101101101101110110000101101110110110110110110000101101110110000101101101101000000110110000110110000101110110000101101101110110000101101101110110000101101110110000110110110000101101111000
000111101101101101110110000101101110110000000110110000101101110110000101101101101101101110110000110110000101110110000101101101110110000101101101110110000101101110110000000110110000101101111000
000111101101101101110110000101101110110000101110110000101101110110000101101110110101101110110000110110110110110110000110110101110110000101110110110110110110000110110000101110110000101101111000
000111101101101101110110000101101110110000101110110000101101110110000101101101110110110110000000101110110110110000000101110110110000000101110110110110110110000110110000101101110000101101111000
000111101101101101101000000101101101000000101101000000101101101000000101101101101000000000000101101101000000000000101101101000000000101101101000000000000000000101000000101101101000101101111000
000111101101101101101101101101101101101101101101101101101101101101101101101101101101101101101101101101101101101101101101101101101101101101101101101101101101101101101101101101101101101101111000
000111111111111111111111111111111111111111111111111111111111111111111111111111111111111111111111111111111111111111111111111111111111111111111111111111111111111111111111111111111111111111111000
000000000000000000000000000000000000000000000000000000000000000000000000000000000000000000000000000000000000000000000000000000000000000000000000000000000000000000000000000000000000000000000000
000000000000000000000000000000000000000000000000000000000000000000000000000000000000000000000000000000000000000000000000000000000000000000000000000000000000000000000000000000000000000000000000
000000000000000000000000000000000000000000000000000000000000000000000000000000000000000000000000000000000000000000000000000000000000000000000000000000000000000000000000000000000000000000000000
000000000000000000000000000000000000000000000000000000000000000000000000000000000000000000000000000000000000000000000000000000000000000000000000000000000000000000000000000000000000000000000000
000000000000000000000000000000000000000000000000000000000000000000000000000000000000000000000000000000000000000000000000000000000000000000000000000000000000000000000000000000000000000000000000
000000000000000000000000000000000000000000000000000000000000000000000000000000000000000000000000000000000000000000000000000000000000000000000000000000000000000000000000000000000000000000000000
000000000000000000000000000000000000000000000000000000000000000000000000000000000000000000000000000000000000000000000000000000000000000000000000000000000000000000000000000000000000000000000000
000000000000000000000000000000000000000000000000000000000000000000000000000000000000000000000000000000000000000000000000000000000000000000000000000000000000000000000000000000000000000000000000
000000000000000000000000000000000000000000000000000000000000000000000000000000000000000000000000000000000000000000000000000000000000000000000000000000000000000000000000000000000000000000000000
